*******************************
*   *   *   * *       * *   * *
* *** * * *** * ******* *** * *
*     *         * * *     *   *
* * * *** *** * * * ***** *** *
* * *   * *   * * * *         *
*** ******* ***** * * * * *****
* *   *       * * * * * *   * *
* * ******* *** * * ***** * * *
* * *             *   * * *   *
* * ************* * *** *** ***
* * *     * *   * *     *     *
* * * ***** * *** * ***** *****
*   *     * *   *   * *   *   *
* ******* * *** * *** * *** * *
*     *   *     *           * *
* * *** *** * * * *********** *
* *       * * *     *       * *
* *** * * * *** ******* *** * *
* *   * * *   *     *   *     *
*******************************
