*******************************
*     * * * * * *       *   * *
* * *** * * * * * *** ***** * *
* * *   * * *   * *       *   *
* * *** * * * * ***** * * * * *
* *     *   * *       * *   * *
* ***** * *** * * *** *** *****
*   *   * *   * * * * *       *
* * *** * * * ***** ***********
* *   * *   * * *       *     *
* ***** *** *** * ***** * * ***
*   *   * *     * *       *   *
*** *** * * ***** ******* *** *
*     *   * * *     * * * *   *
* * * * * * * * *** * * *******
* * * * *       *   *   * *   *
***** * *** ***** * *** * * ***
* *   *   *   * * *           *
* * *** ***** * *** ********* *
*   *     *   *           *   *
*******************************

